xxxxxxxxxxxxxxxxxxxxxxxxxx
x                        x
x                        x
x                        x
x                        x
x                        x
x                        x
x                        x
x                        x
x                        x
x                        x
x                        x
x V                    G x
x       xxx    xxx       x
xxxxxxxxx x    x xxxxxxxxx
        xxx    xxx             