xxxxxxxxxxxxxxxxxxxxxxxxxxxx
x                          x
x                          x
x                         xx
xxx                        x
  x                        x
xxx                    xxxxx
x      V               x    
x                      x    
x                      xxxxx
xx                         x
 xx                      xxx
  xx                   xxx  
   xxxxxxxxxxxxxxxxxxxxx    