xxxxxxxxxxxxxxxxxxxxxxxxxxxx
x                          x
x                          x
x                         xx
xxx                        x
  x                      K x
xxx                    xxxxx
x      V               x    
x                 K    x    
x                      xxxxx
xx           G             x
 xx                      xxx
  xx                   xxx  
   xxxxxxxxxxxxxxxxxxxxx    