xxxxxxxxxxxxxxxxxxxxxxxxxxxxxxxxxx
x x                              x
x x                              x
x x K                            x
xLx                              x
xLxxxxx                          x
xLLLLLx         G                x
xxxxxxx                          x
x             xxxxx              x
x             x   x              x
x             x   x      xxx  K  x
x             x   x      x x     x
x             xxxxx      xxxxxxxxx
x                                x
x                                x
x                                x
x                                x
x V                            K x
x                                x
xxxxxxxxxxxxxxxxxxxLLLLLLLLLLxxxxx
                x xLLLLLLLLLLx   x
                xxxxxxxxxxxxxxxxxx