xxxxxxxxxxxxxxxxxxxxxxxxxxxx
x                          x
x                          x
x                         xx
xxx                        x
xxx                        x
xxx                    xxxxx
x      V               x   x
x                      x   x
x                      xxxxx
xx                         x
xxx                      xxx
xxxx                   xxxxx
xxxxxxxxxxxxxxxxxxxxxxxxxxxx