xxxxxxxxxxxxxxxxxxxxxxxxxxxxxxxxxxxxxxxxxxxxxx
x                                            x
x                                            x
x                                           xx
xxx                                          x
xxx                                          x
xxx                                      xxxxx
x                                        x   x
x      V                                 x   x
x                                        xxxxx
xx                                           x
xxx                                        xxx
xxxx                   xxxxx                 x
xxxxxxxxxxxxxxxxxxxxxxxxxxxxxxxxxxxxxxxxxxxxxx