xxxxxxxxxxxxxxxxxxxxxxxxxx
x                        x
x                        x
x                        x
x                        x
x           G            x
x                        x
x          xxx           x
x          x x           x
x          xxx           x
x                        x
x                        x
x V                    K x
x       xxx   xxx        x
xxxxxxxxx x   x xxxxxxxxxx
        xxx   xxx             